y/x 0 1 2 3 4 5 6 7 8 9
0 8 7 6 9 3 9 9 9 9 8
1 8 7 6 9 3 Z Z Z 9 8
2 8 7 5 8 3 5 6 Z 9 6
3 8 5 7 8 3 4 2 Z 9 7
4 Z Z Z Z 3 Z Z Z Z Z
5 9 8 Z 9 9 3 8 Z 9 9
6 7 7 Z 2 4 3 9 Z 9 9
7 7 8 Z Z Z 3 9 Z 9 9
8 8 7 7 8 9 3 9 9 9 9
9 9 9 8 9 7 3 6 7 9 9